+--+--+--+
F  |     |
+  +  +  +
|     |  |
+--+--+  +
|     |  |
+  +  +  +
|  |     |
+  +--+--+
|        S
+--+--+--+