+---+-+---+---+---+-+
|   | |   |   |   | |
+-+-+ + + + +-+ +-+ +
F |   | | |     |   |
+ + + +-+ +-+-+-+ + +
|   |             | S
+-+-+-+-+-+-+-+-+-+-+