+--+--+--+--+--+--+--+--+--+--+
|  |           |     |     |  |
+  +--+--+  +--+  +  +-S+  +  +
|  |        |     |        |  |
+  +  +  +--+  +  +--+--+--+  +
|     |        |           |  |
+  +--+--+  +--+--+--+--+  +  +
|  |     |     |     |  |     |
+  +--+  +--+  +--+  +  +--+  +
|        |     |     |     |  |
+--+--+--+  +--+  +--+--+  +  +
|        |  |     |     |  |  |
+  +--+  +  +  +--+--+  +  +  +
|  |  |     |  |     |  |  |  |
+  +  +--+--+  +  +  +  +  +  +
|  |  F  |     |  |     |  |  |
+  +  +  +  +--+  +--+--+  +--+
|  |  |  |     |  |     |     |
+  +  +  +  +  +  +  +  +--+  +
|     |     |        |        |
+--+--+--+--+--+--+--+--+--+--+