+--+--+--+--+--+--+--+--+--+--+--+--+--+--+--+--+--+--+--+--+--+--+--+--+--+--+--+--+--+--+
F           |              |     |           |  |        |           |     |     |     |  |
+  +--+--+  +  +--+--+--+  +  +  +--+  +--+  +  +  +--+  +  +--+--+  +  +  +  +  +  +  +  +
|        |  |  |        |  |  |        |     |     |     |     |  |     |  |  |     |  |  |
+--+--+  +  +  +  +--+  +  +  +  +--+--+  +--+--+--+  +  +--+  +  +--+--+  +  +--+--+  +  +
|  |     |     |     |     |  |  |     |     |        |     |     |     |  |        |     |
+  +  +--+--+--+  +  +--+--+  +--+  +  +--+  +  +--+--+--+--+--+--+  +  +  +  +--+  +  +  +
|     |           |  |     |        |     |  |           |     |     |  |     |     |  |  |
+--+--+  +--+--+--+  +--+  +--+  +--+--+  +  +--+--+--+  +  +  +  +--+  +--+--+  +--+  +  +
|     |  |     |  |  |     |  |     |     |        |     |  |     |     |        |     |  |
+  +  +  +  +  +  +  +  +--+  +--+  +  +--+--+  +  +--+  +  +--+--+  +--+--+--+--+  +--+  +
|  |        |     |  |           |  |        |  |        |  |              |        |     |
+  +--+--+--+--+--+  +--+--+--+  +--+--+--+  +  +--+--+--+  +  +--+--+--+  +--+--+  +  +--+
|           |     |  |                 |     |              |  |     |              |     |
+--+--+--+  +  +  +  +  +--+--+  +  +--+  +  +--+  +--+--+--+  +  +  +--+--+--+--+--+  +  +
|  |        |  |        |        |  |     |  |     |        |     |  |                 |  |
+  +  +--+--+--+--+--+--+--+  +--+  +  +--+  +  +--+  +--+  +--+--+  +  +--+--+--+--+--+  +
|        |     |        |     |     |  |     |     |  |  |     |     |        |        |  |
+--+--+  +--+  +  +--+  +  +  +  +--+  +  +--+--+  +  +  +--+  +  +--+--+--+  +  +--+  +  +
|     |     |  |     |     |  |  |     |  |  |     |  |     |     |        |     |     |  |
+  +--+--+  +  +--+  +--+--+--+  +  +--+  +  +--+--+  +--+  +--+--+  +--+  +--+--+  +  +  +
|  |        |                 |     |     |  |     |     |  |           |           |  |  |
+  +  +--+--+--+--+  +--+--+  +--+--+  +--+  +  +  +--+  +  +  +--+--+--+--+--+--+--+--+  +
|     |           |  |     |     |  |           |  |     |     |     |           |     |  |
+--+--+--+--+--+  +  +  +  +--+  +  +  +--+--+  +  +  +--+--+--+--+  +  +  +--+  +  +  +  +
|              |     |  |        |  |        |  |  |  |           |  |  |  |     |  |     |
+  +--+--+--+  +--+--+--+--+  +--+  +--+  +--+  +  +  +  +--+--+  +  +  +--+  +--+  +--+--+
|           |  |              |     |  |     |  |  |        |        |     |     |  |     |
+--+--+--+  +  +--+  +--+--+--+  +  +  +--+  +  +--+--+--+--+  +  +--+--+  +--+  +  +  +  +
|           |                    |  |                          |           |     |     |  S
+--+--+--+--+--+--+--+--+--+--+--+--+--+--+--+--+--+--+--+--+--+--+--+--+--+--+--+--+--+--+