+--+--+--+--+--+--+--+--+--+--+--+--+--+--+--+--+--+--+--+--+--+--+--+--+--+--+--+--+--+--+--+--+--+
|  |     |     |     |           |     |        |     |     |     |  |     |  |     |        |     |
+  +  +  +--+  +  +  +  +--+--+  +  +  +--+  +  +  +  +--+  +  +  +  +  +  +  +  +  +  +--+  +  +  +
|  |  |  |     |  |  |  |        |  |        |     |     |     |     |  |  |  |  |     |  |     |  |
+  +  +  +  +--+--+  +  +--+--+--+  +  +--+--+--+--+--+  +--+--+  +--+  +  +  +  +--+--+  +--+--+  +
|     |  |        |  |        |     |  |           |  |        |     |  |        |           |     |
+--+--+  +  +--+  +  +--+--+  +--+--+  +--+--+  +  +  +--+  +--+--+  +  +--+--+--+  +--+--+--+  +--+
|     |  |  |  |  |        |        |           |        |              |     |     |     |        |
+  +  +  +  +  +  +--+--+  +--+--+  +--+--+--+--+  +  +  +--+--+  +  +--+  +  +  +--+  +  +  +--+--+
|  |  |  |     |  |     |  |        |              |  |  |        |  |     |  |        |     |     |
+--+  +  +--+--+  +  +  +  +  +--+--+  +--+--+--+  +  +  +  +--+--+  +--+  +  +--+--+  +--+--+  +  +
|        |        |  |  |  |     |        |     |  |  |  |  |     |     |  |        |     |     |  |
+  +--+--+  +--+--+  +  +  +--+  +--+--+--+  +  +  +  +  +--+  +  +--+  +--+  +--+  +--+  +  +--+  +
S        |  |        |     |  |           |  |     |  |        |  |  |     |  |     |     |     |  |
+--+--+  +  +  +  +  +--+--+  +--+--+--+  +  +--+--+  +--+--+--+  +  +  +  +  +  +--+  +--+--+  +--+
|     |  |     |  |  |     |     |     |  |  |           |        |  |  |     |     |        |     |
+  +  +  +  +--+--+  +--+  +--+  +  +  +  +  +--+--+--+  +--+--+--+  +--+--+--+--+--+--+--+  +--+  +
|  |  |  |     |              |  |  |  |  |           |     |     |     |                    |     |
+--+  +  +--+  +  +  +--+--+--+  +  +--+  +  +--+--+  +--+  +  +  +  +  +  +--+--+--+--+--+--+  +  +
|     |     |  |  |  |        |  |     |  |  |     |     |  |  |     |     |                    |  |
+  +--+--+  +  +  +  +  +--+  +  +  +  +  +--+  +--+--+  +  +  +--+--+--+--+  +--+--+  +--+--+--+  +
|     |  |     |  |  |  |     |     |  |        |     |  |  |           |     |     |  |        |  |
+--+  +  +--+--+  +  +  +  +--+--+  +  +  +--+--+  +  +--+  +--+--+--+  +--+--+  +  +  +  +--+  +  +
|     |     |     |  |  |  |        |              |        |        |        |  |  |  |     |     |
+  +--+--+  +  +--+  +  +  +  +--+--+--+  +--+--+--+--+--+--+  +--+  +--+--+  +  +  +  +--+  +--+  +
|     |     |  |  |     |        |     |     |           |  |     |        |     |  |  |     |     |
+--+  +  +--+  +  +--+--+--+--+--+  +  +--+  +  +--+--+  +  +  +  +--+--+  +--+  +  +  +  +--+--+  +
|  |  |        |              |     |     |     |     |  |     |  |     |        |  |  |  |        |
+  +  +  +--+--+--+--+--+--+  +  +--+  +--+--+--+--+  +  +--+--+  +  +--+--+--+--+--+  +  +  +--+--+
|  |     |                 |        |                 |  |        |                    |  |  |     |
+  +  +--+  +--+--+--+--+  +--+  +  +--+--+  +--+--+--+  +  +--+--+  +--+--+--+--+--+--+  +  +  +  +
|        |  |        |     |  |  |     |  |              |  |     |  |           |        |  |  |  |
+--+--+--+  +--+  +  +  +--+  +  +  +  +  +--+--+--+  +--+  +--+  +  +  +--+--+  +  +--+--+  +--+  +
|  |     |     |  |     |     |  |  |        |     |     |        |  |        |     |     |        |
+  +  +  +  +  +--+  +--+  +--+  +--+--+--+  +  +  +--+--+--+--+--+  +--+--+  +--+  +  +  +--+--+  +
|  |  |  |  |     |  |  |  |        |     |  |  |        |        |  |     |     |  |  |     |     |
+  +  +  +  +--+  +  +  +  +  +--+  +--+  +  +  +--+--+  +  +--+  +  +  +  +--+  +  +  +--+  +  +--+
|     |  |     |  |  |     |  |  |     |  |  |  |     |  |     |     |  |        |     |  |  |     |
+--+--+  +--+--+  +  +  +--+  +  +--+  +  +  +  +  +  +  +--+  +--+--+  +--+--+--+--+--+  +  +--+  +
|     |        |  |  |  |     |        |  |  |  |  |     |  |  |        |     |        |     |     |
+  +  +--+--+  +  +--+  +  +  +  +--+--+  +--+  +  +--+--+  +  +  +--+--+  +  +  +--+--+--+--+  +--+
|  |     |     |           |  |           |     |  |           |           |  |        |        |  |
+  +--+  +  +  +--+--+  +--+--+--+--+--+--+  +--+  +--+--+  +  +--+--+--+--+  +  +--+  +--+  +--+  +
|  |     |  |                 |     |     |  |     |        |  |           |  |     |     |     |  |
+  +--+--+  +--+--+--+  +  +  +  +  +  +  +  +  +--+  +--+  +  +  +--+  +  +  +--+--+  +  +--+  +  +
|  |     |           |  |  |     |  |  |     |  |     |  |  |  |  |     |  |           |     |     |
+  +  +  +--+--+--+  +  +--+--+--+  +  +--+--+  +  +--+  +  +  +--+  +--+--+--+--+--+--+--+  +--+  +
|     |  |     |     |  |           |  |     |     |        |     |              |        |  |     |
+--+  +  +  +  +  +--+  +  +--+--+--+  +  +--+--+--+  +--+--+  +  +--+--+--+--+  +  +--+  +  +  +--+
|     |     |     |     |              |              |        |                 |     |           |
+--+--+--+--+--+--+--+--+--+--+--+--+--+--+--+--+--+--+--+--+--+--+--+--+--+--+--+-F+--+--+--+--+--+