+--+--+--+--+--+--+--+--+--+--+--+--+--+--+--+--+--+--+--+--+--+--+--+--+--+--+--+--+--+--+--+--+--+
S     |        |     |     |        |        |  |                       |     |  |                 |
+  +  +  +--+  +  +  +--+  +  +  +  +  +--+  +  +  +--+--+--+  +--+--+--+  +  +  +  +--+--+  +--+  +
|  |     |  |  |  |           |  |  |  |  |     |        |     |     |     |     |        |     |  |
+  +--+--+  +  +  +  +--+--+--+  +--+  +  +--+  +  +--+  +--+--+  +--+  +--+--+  +--+--+--+--+--+  +
|        |     |  |        |        |  |        |  |  |     |  |     |     |  |     |     |        |
+--+--+  +--+--+--+--+--+  +--+--+  +  +--+--+--+  +  +--+  +  +  +  +  +  +  +--+  +  +  +  +--+--+
|        |              |     |     |        |     |  |     |     |  |  |  |        |  |  |  |     |
+  +--+--+  +--+--+--+  +--+  +--+--+--+--+  +  +--+  +  +--+--+--+  +--+  +  +--+  +--+  +  +  +  +
|  |        |        |     |  |     |     |  |        |           |     |  |  |  |     |  |  |  |  |
+  +  +--+--+  +--+  +--+  +  +  +  +  +  +  +--+--+--+--+--+  +--+--+  +  +  +  +--+  +  +  +  +  +
|  |  |     |     |     |        |     |  |  |              |        |     |     |     |        |  |
+  +  +  +--+--+  +--+  +  +--+--+--+--+  +  +  +--+--+--+--+--+--+  +--+--+--+--+  +--+--+  +  +  +
|     |     |     |  |     |     |           |     |     |        |  |                       |  |  |
+--+--+--+  +--+  +  +--+--+  +  +  +  +  +--+--+  +--+  +  +--+  +  +  +--+--+--+  +--+--+--+--+  +
|  |     |           |        |     |  |     |     |        |  |     |  |     |           |        |
+  +  +  +--+--+  +--+  +--+--+--+--+--+--+  +  +--+  +--+--+  +--+--+  +  +  +--+  +--+  +  +--+--+
|     |     |     |  |  |     |              |     |  |        |        |  |     |  |     |     |  |
+--+--+--+  +  +--+  +  +  +--+  +--+--+--+--+--+  +  +  +--+--+--+  +--+  +--+  +--+  +--+--+  +  +
|     |     |     |     |     |     |     |     |           |     |  |     |  |  |     |     |  |  |
+  +--+  +--+  +  +  +--+--+  +--+  +  +  +  +  +--+--+  +  +  +  +  +  +--+  +  +  +--+  +  +  +  +
|           |  |  |  |     |     |     |     |     |     |     |  |  |        |     |  |  |        |
+--+--+--+  +--+  +  +  +--+--+  +--+--+--+--+--+  +  +--+--+--+  +  +--+  +--+  +--+  +  +--+  +--+
|        |        |  |     |     |                 |  |           |  |  |     |  |     |     |     |
+  +  +  +--+--+--+  +--+  +--+  +  +--+  +--+--+--+  +  +--+--+--+  +  +--+  +--+  +  +  +--+--+  +
|  |  |           |  |     |     |     |  |           |  |           |        |     |     |        |
+--+  +--+--+--+  +  +  +  +  +--+--+  +  +  +--+--+--+  +  +--+--+--+--+--+--+  +--+--+--+  +  +--+
|     |     |  |  |  |  |     |     |  |     |           |  |                    |           |     |
+  +--+  +  +  +  +  +  +--+--+  +  +--+--+--+  +--+  +--+  +  +--+--+--+--+--+--+  +--+--+--+--+  +
|        |  |  |  |  |  |        |     |  |     |        |  |        |     |     |        |  |     |
+--+--+--+  +  +  +  +  +--+--+--+--+  +  +  +--+--+--+  +  +--+  +  +  +  +  +--+--+--+  +  +  +  +
|  |        |  |     |  |     |     |  |     |           |  |     |  |  |  |  |           |     |  |
+  +  +  +  +  +--+--+  +  +  +  +  +  +--+  +--+--+--+--+  +  +--+  +  +  +  +  +  +--+--+--+--+  +
|     |  |     |        |  |     |     |           |        |  |  |  |  |        |     |     |     |
+  +--+  +--+--+  +--+--+--+--+--+--+  +  +--+--+  +  +--+--+  +  +  +  +  +--+--+--+--+  +  +  +--+
|  |     |     |                 |     |  |        |     |     |     |  |              |  |  |     |
+  +--+--+  +--+--+--+--+--+--+  +  +--+--+  +--+--+--+  +  +  +--+--+  +--+--+--+--+  +  +  +--+--+
|                 |        |     |                 |     |  |        |  |        |     |  |        |
+--+--+--+  +--+  +  +--+  +  +  +--+--+--+  +--+  +  +--+  +--+--+--+  +  +--+  +  +--+--+--+--+  +
|        |  |     |  |     |  |        |     |  |  |  |     |           |     |        |     |     |
+  +--+  +  +  +--+  +  +--+  +--+--+--+  +--+  +  +  +  +--+  +--+--+--+--+  +  +--+--+  +  +  +--+
|  |  |     |     |  |  |     |        |        |     |  |     |     |        |  |     |  |  |     |
+  +  +--+--+  +  +  +--+  +--+  +--+  +--+--+--+--+--+  +  +--+  +--+  +--+--+  +  +  +  +  +--+  +
|  |        |  |  |     |     |  |  |                    |  |                 |  |  |  |  |     |  |
+  +--+  +--+  +--+--+  +  +  +  +  +--+--+--+--+--+--+--+  +  +--+--+--+--+  +  +  +  +  +--+  +  +
|  |     |     |     |     |     |  |        |           |  |  |           |  |     |        |     |
+  +  +--+  +--+  +  +--+--+--+--+  +  +  +--+  +--+--+--+  +  +  +--+--+  +  +--+--+--+  +--+--+--+
|  |     |  |     |  |           |  |  |     |  |           |  |  |     |     |  |        |        |
+  +--+  +  +--+--+  +  +--+--+  +  +  +--+  +  +  +  +--+--+  +  +--+  +--+--+  +  +--+--+  +  +--+
|        |     |  |  |        |  |  |     |  |     |  |     |  |              |     |        |     |
+--+  +--+--+  +  +  +--+--+  +  +  +  +  +  +--+--+--+  +  +  +  +--+--+--+  +  +--+  +--+--+--+  +
|  |        |     |  |     |  |  |  |  |  |  |  |        |     |  |           |  |     |     |     |
+  +--+--+  +  +--+  +  +  +--+  +  +--+  +  +  +  +--+--+--+--+  +  +--+--+--+--+  +--+--+  +  +  +
|     |     |     |  |  |  |              |     |  |           |  |                 |           |  |
+--+  +  +--+--+  +  +  +  +  +--+  +--+  +  +--+  +--+--+--+  +--+--+--+--+--+--+--+  +--+  +--+  +
|        |     |     |  |     |     |     |     |           |  |                 |     |     |     |
+  +--+--+  +--+--+--+  +--+--+  +--+  +--+--+--+--+--+--+  +  +  +--+--+  +--+--+  +--+--+--+  +--+
|  |        |           |  |     |     |  |              |  |     |     |           |           |  |
+  +  +--+--+  +--+--+--+  +  +--+--+  +  +  +--+--+  +  +  +--+--+  +  +--+--+--+--+  +  +--+--+  +
|  |           |     |  |  |  |        |  |        |  |     |     |  |                 |     |     |
+  +--+--+--+--+--+  +  +  +  +  +--+--+  +--+--+  +--+--+--+  +  +--+--+--+--+--+  +--+--+--+  +--+
|     |     |           |  |  |  |        |     |  |        |  |                 |  |           |  |
+--+  +  +  +  +--+--+  +  +  +  +  +--+  +--+  +  +  +--+--+  +--+  +--+--+  +  +  +  +--+--+--+  +
|     |  |     |        |  |  |  |  |  |           |        |  |  |        |  |  |     |        |  |
+  +--+  +--+  +  +--+--+  +  +--+  +  +--+--+--+--+--+--+  +  +  +--+--+  +  +--+--+--+  +--+  +  +
|  |     |     |           |           |  |              |  |  |           |     |     |     |  |  |
+  +  +--+--+--+--+--+--+--+--+--+  +--+  +  +--+--+--+  +  +  +  +--+--+--+--+  +  +  +--+  +  +  +
|  |                       |     |                    |        |  |  |        |     |        |     |
+  +--+--+--+--+--+--+--+  +--+  +--+--+--+--+--+--+--+--+  +--+  +  +  +--+  +--+--+--+  +--+--+--+
|           |           |                                   |  |     |     |  |     |     |        |
+  +--+  +--+  +--+--+  +--+--+--+--+--+--+  +--+--+--+--+--+  +--+  +--+--+  +  +--+  +--+--+  +--+
|  |  |  |     |        |     |     |        |  |     |     |     |        |  |              |     |
+  +  +  +  +  +  +--+  +  +  +  +  +  +--+--+  +  +--+  +--+--+  +--+--+  +  +  +--+  +  +  +--+  +
|  |     |  |  |     |  |  |     |     |     |     |        |  |  |        |     |     |  |        |
+  +--+--+  +  +--+  +  +  +--+--+--+--+  +  +  +  +  +--+  +  +  +  +--+--+--+--+  +--+  +--+--+--+
|        |  |  |     |  |        |     |  |     |     |     |                 |     |     |        |
+--+--+  +--+  +  +--+  +--+--+  +  +  +--+--+--+--+--+  +--+--+--+--+--+--+--+  +--+  +--+  +--+  +
|     |        |  |  |  |     |     |     |     |     |  |  |        |           |     |        |  |
+  +--+--+--+--+  +  +  +  +--+--+--+--+  +  +  +--+  +  +  +  +--+--+  +--+--+--+  +--+--+--+--+  +
|  |              |     |  |     |     |     |           |  |           |           |     |        |
+  +  +--+--+--+--+--+--+  +  +--+  +  +--+  +--+--+--+--+  +--+--+--+  +  +--+--+  +  +  +  +  +--+
|  |  |                    |        |     |  |              |        |  |        |     |  |  |     |
+  +  +  +--+--+--+--+--+  +  +--+--+  +--+  +  +--+--+  +--+  +--+  +--+--+--+  +--+--+  +  +--+--+
|     |        |  |        |  |     |     |  |        |     |     |           |     |     |        |
+--+  +--+--+  +  +  +--+--+  +--+  +--+  +  +--+  +--+--+  +--+  +--+--+--+  +--+  +  +--+  +--+  +
|     |     |  |     |        |        |           |     |     |  |        |     |  |        |     |
+  +--+  +  +  +--+--+  +--+--+  +--+  +--+--+--+--+  +  +  +  +  +  +--+  +--+  +  +--+--+--+  +--+
|  |     |  |           |     |     |  |     |        |     |  |     |  |  |  |     |           |  |
+  +  +--+  +--+--+--+  +  +--+  +  +  +  +  +--+--+  +--+--+  +--+--+  +  +  +--+--+  +  +--+--+  +
|     |     |        |  |        |  |  |  |        |     |  |        |     |  |        |  |        |
+--+--+  +--+  +--+  +--+--+--+--+  +  +  +--+  +  +--+  +  +  +--+  +--+--+  +  +--+--+--+  +--+--+
|        |  |  |  |  |              |  |  |     |        |     |  |  |     |  |  |        |  |     |
+  +--+--+  +  +  +  +  +--+--+--+--+  +  +  +--+--+--+--+--+--+  +  +  +  +  +  +  +--+  +  +  +  +
|  |     |     |  |     |     |     |     |  |              |  |     |  |     |     |     |     |  |
+  +--+  +--+  +  +--+--+  +  +  +  +--+  +  +  +--+--+--+  +  +--+  +  +--+--+  +--+  +--+  +--+  +
|        |           |     |     |  |     |     |        |  |  |     |  |        |  |  |     |     |
+--+--+--+--+--+--+  +  +--+--+--+  +--+--+--+  +--+--+  +  +  +  +--+  +  +--+--+  +  +  +--+  +--+
|        |        |  |  |           |        |  |        |     |     |              |     |     |  |
+  +--+  +  +--+  +  +  +  +--+--+--+  +--+  +  +  +--+--+--+--+--+--+--+  +--+  +--+  +--+  +  +  +
|     |     |           |              |     |  |                          |     |     |     |     F
+--+--+--+--+--+--+--+--+--+--+--+--+--+--+--+--+--+--+--+--+--+--+--+--+--+--+--+--+--+--+--+--+--+