+--+--+--+--+--+--+--+--+--+--+--+--+--+--+--+--+--+--+--+--+--+--+--+--+--+--+--+--+--+--+--+--+--+
|              |           |           |        |                             |     |     |        |
+  +--+--+--+--+  +  +--+  +  +--+  +--+  +--+  +  +--+--+  +--+--+--+--+--+--+  +  +  +  +--+  +  +
|           |     |  |     |  |     |     |     |        |     |        |        |  |  |     |  |  |
+--+--+--+  +  +--+--+  +--+  +  +--+  +--+--+--+--+--+  +--+  +  +  +--+  +--+--+  +  +--+  +  +  +
|     |  |  |  |           |  |  |  |     |     |     |     |     |        |        |  |        |  |
+  +  +  +  +  +  +--+--+--+  +  +  +  +  +  +  +  +--+  +  +--+--+--+--+--+  +  +--+  +  +--+--+  +
|  |     |     |     |        |        |     |  |        |     |        |     |  |     |  |     |  |
+  +--+--+--+--+--+  +  +--+--+--+--+--+--+--+  +--+--+--+--+  +  +--+--+  +--+--+  +--+  +  +  +  +
|              |     |  |     |     |        |     |     |  |     |        |     |     |     |  |  |
+  +--+--+  +--+  +  +  +  +  +  +  +--+  +  +--+  +  +  +  +--+--+  +--+  +  +  +--+  +--+--+  +  +
|        |        |     |  |  |  |     |  |        |  |     |  |     |     |  |     |  |     |  |  |
+  +--+  +--+--+--+--+--+  +--+  +--+  +  +--+  +--+  +--+--+  +  +--+--+  +  +--+  +  +  +  +  +--+
|  |  |  |        |              |     |     |           |        |     |  |  |  |  |     |  |     |
+  +  +  +  +--+  +--+--+  +--+--+  +--+--+--+--+--+--+  +  +--+--+--+  +--+  +  +  +--+--+  +  +  +
|     |     |  |  |        |     |        |     |        |     |     |     |  |     |        |  |  |
+  +--+--+--+  +  +  +--+--+--+  +--+--+  +  +  +--+--+  +--+  +  +  +  +  +  +  +  +--+--+--+  +  +
|           |  |     |           |           |  |     |           |     |     |  |           |  |  |
+--+--+--+  +  +--+--+--+--+--+  +  +--+  +--+  +  +  +--+--+  +--+--+--+--+--+  +--+--+--+  +--+  +
|     |  |     S        |  |     |  |     |  |     |        |  |     |           |     |     |     |
+  +  +  +--+  +  +--+  +  +  +--+  +  +--+  +--+--+--+--+  +  +  +  +--+  +--+--+  +  +--+  +  +--+
|  |  |     |  |     |     |  |     |  |     |        |        |  |        |        |        |     |
+--+  +--+  +--+--+  +--+  +  +--+--+  +  +--+  +--+  +  +  +--+  +--+--+--+  +--+--+--+--+--+--+  +
|     |           |     |     |     |     |     |  |     |  |     |        |                 |     |
+  +--+  +--+--+  +--+  +--+--+  +  +--+--+--+--+  +--+--+--+  +--+  +--+  +--+  +--+--+--+  +  +--+
|  |     |           |        |  |           |                 |  |  |     |  |     |     |        |
+  +--+--+  +--+  +  +--+--+  +  +--+--+--+  +--+  +--+--+  +--+  +  +  +--+  +--+  +  +  +--+--+  +
|        |  |     |        |     |        |     |        |     |     |  |        |  |  |  |        |
+  +--+  +  +  +--+--+  +--+--+--+  +  +  +--+  +--+--+  +  +  +--+--+  +  +  +  +  +  +  +  +--+--+
|     |     |  |     |           |  |  |     |  |     |  |  |  |     |  |  |  |  |  |  |  |        |
+--+--+--+--+  +  +  +--+--+--+  +--+  +--+  +  +  +  +  +--+  +  +  +  +--+  +  +  +--+  +--+--+  +
|              |  |        |     |     |  |     |  |  |     |  |  |  |        |  |     |           |
+  +--+--+--+--+  +--+--+  +  +--+  +--+  +--+  +  +  +--+  +  +  +  +--+--+--+  +--+  +  +  +--+--+
|  |        |  |        |     |     |     |     |  |     |  |  |  |  |     |     |     |  |        |
+  +  +--+  +  +--+  +  +--+--+  +--+  +  +  +--+  +--+  +--+  +--+  +  +--+  +--+  +--+  +--+--+  +
|  |     |  |  |     |     |     |     |  |     |     |  |     |     |        |     |  |  |        |
+  +--+--+  +  +--+  +--+  +  +--+  +--+  +--+  +--+  +  +  +--+  +  +  +--+--+  +--+  +  +  +--+--+
|  |     |  |     |     |     |  |  |  |  |           |     |     |  |     |  |  |        |  |     |
+  +  +  +  +  +  +--+--+--+--+  +  +  +  +  +  +--+--+--+--+  +--+  +--+  +  +  +--+  +--+  +  +  +
|     |     |  |     |        |     |  |     |                 |  |     |  |     |     |  |     |  |
+--+  +--+--+  +--+  +  +--+  +--+--+  +--+  +--+--+--+--+--+--+  +--+  +  +--+--+  +--+  +--+--+  +
|  |  |        |     |  |     |     |        |                 |     |     |        |              |
+  +  +  +  +--+--+--+  +--+--+  +  +--+--+--+  +--+--+--+--+  +--+  +--+--+  +--+--+  +--+  +--+--+
|  |  |  |     |     |           |        |        |        |  |              |     |     |  |     |
+  +  +  +--+--+  +  +--+--+--+--+--+--+  +  +--+  +  +  +  +  +  +--+--+  +--+--+  +--+--+  +  +  +
|  |     |        |  |     |           |     |     |  |  |     |     |  |           |  |     |  |  |
+  +--+--+  +--+--+  +--+  +  +--+--+  +--+--+  +--+--+  +--+--+--+  +  +  +--+--+--+  +  +--+--+  +
|                 |           |     |           |  |     |     |     |     |     |  |           |  |
+--+--+  +--+--+  +--+--+--+--+  +  +--+  +  +--+  +  +--+  +  +  +--+--+--+  +  +  +--+--+--+  +  +
|     |  |              |     |  |  |     |     |  |  |     |  |     |     |  |     |        |     |
+--+  +--+  +--+--+--+  +  +  +  +  +  +--+--+  +  +  +--+  +--+  +  +--+  +  +--+  +  +--+  +--+--+
|        |  |        |  |  |  |  |     |     |     |     |        |              |  |  |           |
+  +--+  +  +  +--+--+  +  +  +  +--+--+  +--+--+--+--+  +  +--+--+--+--+  +--+--+  +  +  +--+--+  +
|  |     |  |              |  |        |           |  |     |     |        |        |  |  |     |  |
+  +--+--+  +--+--+--+  +--+--+--+  +  +--+--+--+  +  +--+--+  +  +  +--+--+  +--+--+  +  +  +  +--+
|           |        |  |  |     |  |     |     |  |     |     |  |     |     |        |  |  |     |
+--+--+--+--+  +--+  +  +  +  +--+  +--+--+  +  +  +--+  +  +--+  +--+--+  +--+--+--+  +  +  +--+  +
|           |  |  |     |        |     |     |              |  |     |     |     |     |  |  |     |
+  +--+  +--+  +  +--+--+--+  +  +--+  +  +--+--+  +  +  +--+  +--+  +  +--+  +  +  +--+  +  +  +--+
|  |  |        |        |     |        |  |     |  |  |  |  |     |  |  |     |     |     |  |     |
+  +  +--+--+--+--+--+  +  +--+--+--+--+  +  +  +--+  +  +  +  +  +  +  +--+  +--+--+--+  +  +  +  +
|  |  |  |              |        |     |  |  |        |     |  |     |        |        |  |  |  |  |
+  +  +  +  +--+--+--+--+--+--+  +  +  +  +  +--+--+--+--+--+--+--+--+--+--+--+  +--+  +  +  +  +  +
|  |  |  |  |        |        |     |     |           |  |        |        |  |     |  |  |  |  |  |
+  +  +  +  +  +--+  +  +--+  +--+--+--+--+--+--+--+  +  +  +--+  +  +--+  +  +--+  +  +  +  +  +  +
|     |  |        |  |  |  |  |                    |     |     |  |     |     |     |        |  |  |
+--+--+  +--+  +  +--+  +  +  +--+--+--+--+--+  +--+--+  +  +--+  +--+--+--+  +--+--+--+--+--+  +  +
|     |  |     |     |  |  |                       |     |     |     |     |  |                 |  |
+  +--+  +  +--+--+  +  +  +--+--+--+--+--+--+  +  +  +--+--+  +--+  +  +  +  +  +--+--+--+--+--+  +
|     |  |  |     |  |  |           |        |  |     |     |  |     |  |  |     |        |  |     |
+--+  +  +  +  +  +  +  +--+  +--+  +  +--+  +  +--+--+  +  +  +  +--+--+  +--+--+  +--+  +  +  +--+
|     |     |  |  |     |     |     |  |  |  |           |  |  |        |     |     |     |        |
+  +  +--+--+  +--+--+--+--+--+  +  +  +  +  +--+--+--+  +  +  +  +--+  +--+  +--+--+  +--+--+--+  +
|  |     |     |     |           |     |  |  |           |     |     |     |        |     |        |
+  +--+  +  +  +  +  +  +--+--+--+--+--+  +  +--+  +--+--+--+--+--+  +--+  +--+  +  +--+  +  +--+--+
|     |     |     |  |  |                 |        |           |        |        |     |  |  |     |
+--+  +--+--+--+  +  +  +  +--+--+--+--+--+--+--+--+  +--+--+  +  +--+  +--+--+--+--+  +  +  +  +--+
|  |  |  |        |  |  |        |     |     |     |  |     |     |     |              |     |     |
+  +  +  +  +--+--+  +  +--+  +  +  +--+  +  +  +--+  +  +  +--+--+--+--+  +--+--+--+--+  +--+--+  +
|  |  |     |     |     |     |     |     |  |     |  |  |                 |  |        |  |     |  |
+  +  +--+  +  +  +--+  +  +--+--+--+  +--+  +--+  +  +  +--+--+--+  +--+  +  +  +--+  +  +  +  +  +
|     |        |     |  |        |     |     |  |     |  |     |     |     |     |  |     |  |  |  |
+--+--+--+--+--+--+  +--+--+  +  +  +--+--+  +  +--+--+  +--+  +  +--+  +--+--+--+  +--+--+  +  +  +
|        |        |     |     |  |  |        |  |     |        |     |  |  |        |        |  |  |
+--+--+  +  +--+  +--+  +--+  +  +  +--+--+--+  +  +  +--+--+--+--+  +  +  +  +--+--+--+--+--+  +  +
|           |  |     |        |  |           |     |  |              |     |  |        |        |  |
+  +--+--+--+  +--+  +--+--+--+  +  +--+--+  +--+--+  +  +--+--+--+--+--+--+  +  +--+  +  +  +--+  +
|  |  |     |  |              |     |        |     |  |  |                    |     |     |     |  |
+  +  +  +--+  +--+--+--+  +--+--+--+  +--+--+  +  +  +  +  +--+--+--+--+--+--+--+  +  +--+--+  +  +
|              |        |  |           |     |  |     |     |              |  |     |     |  |     |
+  +--+  +--+  +  +--+--+  +  +--+--+  +--+  +  +--+--+  +--+  +  +--+--+  +  +  +--+--+  +  +--+--+
|  |     |     |  |        |  |        |     |     |  |     |  |  |           |        |     |     |
+  +--+--+  +--+  +  +--+--+  +  +--+--+  +--+--+  +  +--+  +  +  +--+--+  +  +--+--+  +--+--+--+  +
|     |  |        |           |           |        F     |  |  |     |     |     |                 |
+--+  +  +--+--+  +--+--+--+--+--+--+--+--+--+  +--+--+  +  +--+--+  +  +--+--+  +  +  +--+--+--+--+
|  |  |  |     |  |        |     |           |  |     |  |           |  |        |  |     |        |
+  +  +  +--+  +  +  +--+  +  +  +  +--+--+  +  +  +  +  +--+--+--+--+  +  +--+--+  +--+  +--+  +  +
|     |  |        |     |  |  |     |     |     |  |  |        |        |           |  |     |  |  |
+--+  +  +  +  +--+--+  +  +  +  +--+  +  +--+--+  +  +--+--+  +  +--+--+--+  +--+--+  +--+  +  +  +
|     |     |           |     |        |           |        |     |                    |        |  |
+--+--+--+--+--+--+--+--+--+--+--+--+--+--+--+--+--+--+--+--+--+--+--+--+--+--+--+--+--+--+--+--+--+